alias ..='cd ..'
alias ...='cd ../../'
alias c='clear'
alias cdFastapi='cd /workspace/REST-API-Server'
alias cdJekyll='cd /workspace/GITHUB-IO'
alias cdSvelte='cd /workspace/TEST-SVELTE-FRONTEND'
alias checkFastapi='cd /workspace/REST-API-Server/ && tail -f nohup.out'
alias checkJekyll='cd /workspace/GITHUB-IO && tail -f nohup.out'
alias checkJekyllMM='cd /workspace/minimal-mistakes && tail -f nohup.out'
alias du_='du -h -d 1'
alias egrep='egrep --color=auto'
alias fgrep='fgrep --color=auto'
alias gf='git fetch'
alias gitPush='git-push.sh'
alias gitpushUpdate='git add . && git commit -m "update" && git push origin +master'
alias gm='git merge'
alias gp='git pull'
alias grep='grep --color=auto'
alias gs='git status'
alias l='ls -lt'
alias la='ls -alt'
alias ls='ls --color=auto'
alias q='exit'
alias runFastapi='cd /workspace/REST-API-Server && nohup uvicorn main:app --host 0.0.0.0 --port 80 --reload &'
alias runJekyll='cd /workspace/GITHUB-IO && nohup bundle exec jekyll serve --host 0.0.0.0 --watch --drafts &'
alias runJekyllMM='cd /workspace/v2 && nohup bundle exec jekyll serve --host 0.0.0.0 --port 4001 --watch --drafts &'
alias runSvelte='cd /workspace/TEST-SVELTE-FRONTEND && npm run dev -- --host 0.0.0.0 --port 5173'
alias sb='source ~/.bashrc'
alias stopFastapi='lsof -i :80'
alias stopJekyll='lsof -i :4000'
alias stopJekyllMM='lsof -i :4001'
alias stopSvelte='lsof -i :5173'
alias vi='nvim'
alias vimInstall='vim +PluginInstall +qall'